**###****
**#+#****
**#+####*
###++++#*
#++++###*
####+#***
***#+#***
***###***
*********